1111111111111111111
11111101P0001111111
1111110000111111111
1000000000000000001
1000000000000000001
10C0000000000E00001
1000011001100000001
11C1111111111000111
111111111111C111111
1111111111111111111