1111111111111111111
11011101P0001101111
1101110000111101111
1000000000000000001
1000000000000000001
1000000000000E00001
1000011001100000001
1101111111111000111
110111111111C101111
1111111111111111111