111111111111111111111111111111111111111111111111111111111111111111111111111111111111111111111111
1000000000000000000000000000000000000C000000000000000000000000000000000000000000000000000001
1000000000000000000000000000000000000C000000000000000000000000000000000000000000000000000001
1000000000000000000000000000000000000C000000000000000000000000000000000000000000000000000001
1000000000000000000000000000000000000C000000000000000000000000000000000000000000000000000001
1000000000000000000000000000000000000C000000000000000000000000000000000000000000000000000001
1000000000000000000000000000000000000C000000000000000000000000000000000000000000000000000001
1000000000000000000000000000000000000C000000000000000000000000000000000000000000000000000001
1000000000000000000000000000000000000C000000000000000000000000000000000000000000000000000001
1000000000000000000000000000000000000C000000000000000000000000000000000000000000000000000001
1000000000000000000000000000000000000C0000000000000000000000000000000000000000000000000000111
1000000000000000000000000000000000000C000000000000000000000000000000000000000000000000000001
1000000000000000000000000000000000000C000000000000000000000000000000000000000000000000000001
1000000000000000000000000000000000000C0000000000000000000000000000000000000000000000000000111
1000000000000000000000000000000P000000000000000000000000000000000000000000000000000000000E0111
111111111111111111111111111111111111111111111111111111111111111111111111111111111111111111111111