11111111111111111111111111111111111111
10110000000000000000000000CC1111111111
10110000000000000000000000CC1111111111
10110000000000000000000000CC1111111111
10110000000000000000000000CC1111111111
10110000000000000000000000CC1111111111
10110000000000000000000000CC1111111111
10110000000000000000000000CC1111111111
10110000000000000000000000CC1111111111
10110000000000000000000000CC1111111111
10110000000000000000000000CC1111111111
10110000000000000000000000CC1111111111
10110000000000000000000000CC1111111111
11CCC0000000000000000011111C1111111111
11CCC0000000000000000011111C1111111111
11CCC0000000000000000011111C1111111111
1P0001EC0000000000000000CCCC1111111111
11111111111111111111111111111111111111