111111111111111111111111
111100000000000000001111
111001111000000000000111
110000110000000000000011
100001111000000000000001
100000000000000000000001
100000000000000000000001
1000000000000P0000000001
100000000000000000000001
11000000C000000000000011
111000000000000000000111
111100000000000000001111
111110000000000000011111
1111111000000E000011
111111110000000001111111
111111111111111111111111