1111111111
1100110E11
110000C111
11C0011111
1000111111
101000C111
11P0011111
1111111111