1111111111111111111
1111111111111111111
11P00000000C0000111
1111110C11111111111
1111110111111111111
11111000C1111111111
11110C0111111111111
11100000000C0000C01
111111111110100C111
1E0000000C000C00001
1111111111111111111