111111111111111111111111111111111111111
10000C000000000000000000000000000000CC1
1000000000000000C0000000000000000000001
10000000011111111100000C000000000P00001
100000000000000000000000000000000000001
100000000000000000000000000000000000001
100000000000000000000000000000000000001
1000C00000000000111111110000C0000000001
100000000000000000000000000000000000001
100000000000000000000000000000000000001
1000000110111100000000C0000011110100001
100000000000000000000000000000000000001
100000000000000000000000000000000000001
100000000000000000000000000111100000001
100000000000101111111110000000000000001
100000000000000000000000000000000000001
1000C0000000000000000000000000000000001
100000000000000000000000000000000000001
1000E0000000000000000000000000000000001
100000000000000000000000000000000000001
100000000000000000000000000000000000001
111111111111111111111111111111111111111